9 9 9 9 9 9 9 9 9 9 9 9 9 9 9 9 9 9 9 9 9
9 9 9 9 9 9 9 9 9 9 9 9 9 9 9 9 9 9 9 9 9
9 0 0 0 0 0 0 0 0 0 0 0 0 0 0 0 0 0 0 0 9
9 0 2 2 2 2 2 2 2 2 0 2 2 2 2 2 2 2 2 0 9
9 0 3 0 0 2 0 0 0 2 0 2 0 0 0 2 0 0 3 0 9
9 0 2 1 2 2 2 2 2 2 2 2 2 2 2 2 2 2 2 0 9
9 0 2 0 0 2 0 2 0 0 0 0 0 2 0 2 0 0 2 0 9
9 0 2 2 2 2 0 2 2 2 0 2 2 2 0 2 2 2 2 0 9
9 0 0 0 0 2 0 0 0 2 0 2 0 0 0 2 0 0 0 0 9
9 0 0 0 0 2 0 2 2 2 2 2 2 2 0 2 0 0 0 0 9
9 0 0 0 0 2 0 2 0 0 9 0 0 2 0 2 0 0 0 0 9
9 0 2 2 2 2 2 2 0 9 9 9 0 2 2 2 2 2 2 0 9
9 0 0 0 0 2 0 2 0 0 0 0 0 2 0 2 0 0 0 0 9
9 0 0 0 0 2 0 2 2 2 2 2 2 2 0 2 0 0 0 0 9
9 0 0 0 0 2 0 2 0 0 0 0 0 2 0 2 0 0 0 0 9
9 0 2 2 2 2 2 2 2 2 0 2 2 2 2 2 2 2 2 0 9
9 0 2 0 0 2 0 0 0 2 0 2 0 0 0 2 0 0 2 0 9
9 0 3 2 0 2 2 2 2 2 2 2 2 2 2 2 0 2 3 0 9
9 0 0 2 0 2 0 2 0 0 0 0 0 2 0 2 0 2 0 0 9
9 0 2 2 2 2 0 2 2 2 0 2 2 2 0 2 2 2 2 0 9
9 0 2 0 0 0 0 0 0 2 0 2 0 0 0 0 0 0 2 0 9
9 0 2 2 2 2 2 2 2 2 2 2 2 2 2 2 2 2 2 0 9
9 0 0 0 0 0 0 0 0 0 0 0 0 0 0 0 0 0 0 0 9